1111111111111111111111111111111111111111111111111
1110000000000010000000100000010000000000000000000111
10000100000100100001000000100000000000010000000000001
1000010100010000011100000010000100001111100000000001
111111010000010001000000001111100000100010000000001
10000001100000000100000000000000000011010000000001
1000000000000100010000000010000000000001000000001
1000001100000000000000000000000000000000000000001
1000000110000000000010000000001100000000000000001
1000000000000000000010000000000100000000000000001
100011100000000111111111000000010000011111000001
1000000000000000000000000000000000000000000000001
1000000000000000000000000000100000000000000000001
1111111111111111111111111111111111111111111111111